1Y 1Y 1Y 1Y 1Y 1Y 1Y 1Y 1Y 1Y 1Y 1Y 1Y 1Y 1Y 1Y 1Y 1Y 1Y 1Y
1B 1B 1B 1B 1B 1B 1B 1B 1B 1B 1B 1B 1B 1B 1B 1B 1B 1B 1B 1B
2S 1B 2S 1B 1B 2S 1B 1B 2S 1B 1B 2S 2S 2S 1B 2S 1B 2S 1B 1B
2S 1B 2S 2S 1B 2S 1B 2S 1B 2S 1B 1B 1S 1B 1B 2S 1B 2S 1B 1B
2S 1B 2S 2S 1B 2S 1B 2S 1B 1B 1B 1B 1S 1B 1B 2S 1B 2S 1B 1B
2S 1B 2S 1B 2S 2S 1B 1B 2S 1B 1B 1B 1S 1B 1B 2S 1B 2S 1B 1B
2S 1B 2S 1B 2S 2S 1B 1B 1B 2S 1B 1B 1S 1B 1B 2S 1B 2S 1B 1B
2S 1B 2S 1B 1B 2S 1B 2S 1B 2S 1B 1B 1S 1B 1B 2S 1B 2S 1B 1B
2S 1B 2S 1B 1B 2S 1B 1B 2S 1B 1B 1B 1S 1B 1B 2S 1B 2S 2S 1S
1B 1B 1B 1B 1B 1B 1B 1B 1B 1B 1B 1B 1B 1B 1B 1B 1B 1B 1B 1B
1Y 1Y 1Y 1Y 1Y 1Y 1Y 1Y 1Y 1Y 1Y 1Y 1Y 1Y 1Y 1Y 1Y 1Y 1Y 1Y
